WE                ./bonus/texture/we.png
NO ./bonus/texture/no.png
EA ./bonus/texture/ea.png
SO ./bonus/texture/so.png


F      0,0,120
C 100,100,      100

11111111111111111111111
11111100000000000000001
1000000000000000000000111111
10000000000000000000001
10000011111111111110001
10001100000000000000001
10000S00000000000000001
10000000100000000000001
10000001111111100000001
10000000000000000000001
10001011100000000000001
10000000000000000000001
11111111100111111111111
        1001
        1001
        1001
        1001
        1001
        1001
        1001
        1001
        1001
        1001
        1001
        1001
11111111100111111111111
10000000000000000000001
10001111100000000000001
10000000000000000000001
10000011111111111110001
10001000000000000000001
10000000000000000000001
10000000000000000000001
10000001111111100000001
10000000000000000000001
10000000000000000000001
11111100000000000000001
11111111111111111111111